33333333333333333333
33333333333333333333
33333333333333333333
33333333333333333333
33333333333333333333
33333333333333333333
33333333333333333333
33333333333333333333
33333333333333333333
33333333333333333333
33333333333333333333
33333333333333333333
33333333333333333333
33333333333333333333
33333333333333333333
33333333333333333333
33333333333333333333
33333333333333333333
33333333333333333333
33333333333333333333

44444444444444444444
4                 44
4                 44
4  11111111111111114
4  11111111111111114
41111111111111111114
41111111111111111114
11111111111111111114
41111111111111111114
41111111111111111114
41111111111111111114
41111111111111111114
41111111111111111114
41111111111111111114
41111111111111111114
411111      11111114
41111          11114
41111111    11111114
41111111111111111114
44444444444444444444

44444444444444444444
1                 11
1                 11
1  11111111111111111
1  11111111111111111
11111111111111111111
11111111111111111111
11111111111111111111
11111111111111111111
11111111111111111111
11111111111111111111
11111111111111111111
11111111111111111111
11111111111111111111
1111111   1111111111
1111          111111
1111             111
111111          1111
111111111     111111
44444444444444444444

44444444444444444444
1111111111111111  11
1111111111111111  11
1   111111111111  11
1   1111111111111111
11111111111111111111
11111111111111111111
11111111111111111111
11111111111111111111
11111111111111111111
11111111111111111111
11111111111111111111
11111111111111111111
111              111
1                  1
1                  1
1                 11
11               111
11111           1111
44444444444444444444

44444444444444444444
1                  1
1                  1
1                  1
1                  1
1                  1
1 2 22             1
1 2  2    11       1
1 2  2   1111      1
1 22 1   111       1
1                  1
11                11
11                11
11                11
1                  1
1                  1
1                  1
1                 11
11                11
44444444444444444444

44444444444444444444
1                  1
1                  1
1                  1
1                  1
1                  1
1 2 22             1
1 2       1        1
1 2  2    111      1
1 22 2    11       1
1                  1
1                  1
1                  1
1                 11
1                  1
1                  1
1                  1
1                  1
1                  1
44444444444444444444

44444444444444444444
1                  1
1                  1
1                  1
1                  1
1                  1
1 2222             1
1 2222             1
1 2222    1        1
1 2222             1
1                  1
1                  1
1                  1
1                  1
1                  1
1                  1
1                  1
1                  1
1                  1
44444444444444444444

44444444444444444444
1                  1
1                  1
1                  1
1                  1
1                  1
1                  1
1                  1
1                  1
1                  1
1                  1
1                  1
1                  1
1                  1
1                  1
1                  1
1                  1
1                  1
1                  1
44444444444444444444