                                        
4444444444444444444444444444444444444444
4333333333333333333333333333333333333334
4333333333333333333333333333333333333334
4333333333333333333333333333333333333334
4333333333333333333333333333333333333334
4333333333333333333333333333333333333334
4333333333333333333333333333333333333334
4333333333333333333333333333333333333334
4333333333333333333333333333333333333334
4333333333333333333333333333333333333334
4333333333333333333333333333333333333334
4333333333333333333333333333333333333334
4333333333333333333333333333333333333334
4333333333333333333333333333333333333334
4333333333333333333333333333333333333334
4333333333333333333333333333333333333334
4333333333333333333333333333333333333334
4333333333333333333333333333333333333334
4333333333333333333333333333333333333334
4333333333333333333333333333333333333334
4333333333333333333333333333333333333334
4333333333333333333333333333333333333334
4333333333333333333333333333333333333334
4333333333333333333333333333333333333334
4333333333333333333333333333333333333334
4333333333333333333333333333333333333334
4333333333333333333333333333333333333334
4333333333333333333333333333333333333334
4333333333333333333333333333333333333334
4333333333333333333333333333333333333334
4333333333333333333333333333333333333334
4333333333333333333333333333333333333334
4333333333333333333333333333333333333334
4333333333333333333333333333333333333334
4333333333333333333333333333333333333334
4333333333333333333333333333333333333334
4333333333333333333333333333333333333334
4333333333333333333333333333333333333334
4333333333333333333333333333333333333334
4444444444444444444444444444444444444444

4444444444444444444444444444444444444444
4                                      4
4                                      4
4                                      4
4                                      4
4                                      4
4                                      4
4                                      4
4                                      4
4                                      4
4                                      4
4                                      4
4                                      4
4                                      4
4                                      4
4                                      4
4                                      4
4                                      4
4                                      4
4                                      4
4                                      4
4                                      4
4                                      4
4                                      4
4                                      4
4                                      4
4                                      4
4                                      4
4                                      4
4                                      4
4                                      4
4                                      4
4                                      4
4                                      4
4                                      4
4                                      4
4                                      4
4                                      4
4                                      4
4444444444444444444444444444444444444444

4444444444444444444444444444444444444444
4                                      4
4                                      4
4                                      4
4                                      4
4                                      4
4                                      4
4                                      4
4                                      4
4                                      4
4                                      4
4                                      4
4                                      4
4                                      4
4                                      4
4                                      4
4                                      4
4                                      4
4                                      4
4                                      4
4                                      4
4                                      4
4                                      4
4                                      4
4                                      4
4                                      4
4                                      4
4                                      4
4                                      4
4                                      4
4                                      4
4                                      4
4                                      4
4                                      4
4                                      4
4                                      4
4                                      4
4                                      4
4                                      4
4444444444444444444444444444444444444444

4444444444444444444444444444444444444444
4                                      4
4                                      4
4                                      4
4                                      4
4                                      4
4                                      4
4                                      4
4                                      4
4                                      4
4                                      4
4                                      4
4                                      4
4                                      4
4                                      4
4                                      4
4                                      4
4                                      4
4                                      4
4                                      4
4                                      4
4                                      4
4                                      4
4                                      4
4                                      4
4                                      4
4                                      4
4                                      4
4                                      4
4                                      4
4                                      4
4                                      4
4                                      4
4                                      4
4                                      4
4                                      4
4                                      4
4                                      4
4                                      4
4444444444444444444444444444444444444444

4444444444444444444444444444444444444444
4                                      4
4                                      4
4                                      4
4                                      4
4                                      4
4                                      4
4                                      4
4                                      4
4                                      4
4                                      4
4                                      4
4                                      4
4                                      4
4                                      4
4                                      4
4                                      4
4                                      4
4                                      4
4                                      4
4                                      4
4                                      4
4                                      4
4                                      4
4                                      4
4                                      4
4                                      4
4                                      4
4                                      4
4                                      4
4                                      4
4                                      4
4                                      4
4                                      4
4                                      4
4                                      4
4                                      4
4                                      4
4                                      4
4444444444444444444444444444444444444444

4444444444444444444444444444444444444444
4                                      4
4                                      4
4                                      4
4                                      4
4                                      4
4                                      4
4                                      4
4                                      4
4                                      4
4                                      4
4                                      4
4                                      4
4                                      4
4                                      4
4                                      4
4                                      4
4                                      4
4                                      4
4                                      4
4                                      4
4                                      4
4                                      4
4                                      4
4                                      4
4                                      4
4                                      4
4                                      4
4                                      4
4                                      4
4                                      4
4                                      4
4                                      4
4                                      4
4                                      4
4                                      4
4                                      4
4                                      4
4                                      4
4444444444444444444444444444444444444444
                                        
4444444444444444444444444444444444444444
4                                      4
4                                      4
4                                      4
4                                      4
4                                      4
4                                      4
4                                      4
4                                      4
4                                      4
4                                      4
4                                      4
4                                      4
4                                      4
4                                      4
4                                      4
4                                      4
4                                      4
4                                      4
4                                      4
4                                      4
4                                      4
4                                      4
4                                      4
4                                      4
4                                      4
4                                      4
4                                      4
4                                      4
4                                      4
4                                      4
4                                      4
4                                      4
4                                      4
4                                      4
4                                      4
4                                      4
4                                      4
4                                      4
4444444444444444444444444444444444444444