1,1,1,0,1,1
0,4,4,4,4,0
0,4,4,4,4,0
0,4,4,4,4,0
1,4,4,4,4,1
1,0,0,0,1,0
n,
1,1,1,1,1,1
1,6,6,6,6,1
1,1,0,0,1,1
1,0,0,0,0,1
1,7,7,7,7,1
1,1,1,1,1,1
n,
2,1,1,1,1,2
1,0,0,0,0,1
1,0,0,0,0,1
1,0,0,0,0,1
1,0,0,0,0,1
2,1,1,1,1,2
